11111111111111111111111111
10100110010010000001000001
10000101000101C10000010E11
1000000P000000010000010111
11111111111111111111111111
